|¯¯¯¯¯¯¯¯¯¯¯¯¯¯¯¯¯¯¯¯¯¯¯¯¯¯¯¯¯¯¯¯¯¯¯¯¯¯¯|
|                     ┌────┐            |
|┌────┐               ├────┤┌────┐      |
|├────┤═══════════════|.*.*|├────┤══════|
||.*.*|         ┌────┐└────┘|.*.*|     +|    Almacen
|└────┘┌────┐   ├────┤      └────┘      |
|      ├────┤   |.*.*|            ┌────┐|
|      |.*.*|   └┌────┐           ├────┤|
|    ┌────┐─┘    ├────┤           |.*.*||
|    ├────┤      |.*.*|        ┌────┐──┘|
|    |.*.*|      └────┘        ├────┤   |
|    └────┘┌────┐              |.*.*|   |
|+         ├────┤              └────┘   |
|¯¯¯¯¯¯¯¯¯¯¯¯¯¯¯¯¯¯¯¯¯¯¯¯¯¯¯¯¯¯¯¯¯¯¯¯¯¯¯|
|                                       |
|                      ┌─┐              |
|══════════════════════| |══════════════|