|XX¯├─┤¯¯¯¯¯¯¯¯¯¯¯¯¯¯¯¯¯¯¯¯¯¯¯¯¯¯¯¯¯¯¯¯¯¯¯XX|
|   ├─┤                 \    /|  |\_/    XXX|
|X  ├─┤          ┌───┐   \/\/  O ┤ /       X| Sotano
|XX═├─┤══════════├───┤════════/|\═══════════|
|   ├─┤          |___|         ^            |
|                                           |
|¯¯¯¯¯¯¯¯¯¯¯¯¯¯¯¯¯¯¯¯¯¯¯¯¯¯¯¯¯¯¯¯¯¯¯¯¯¯¯¯¯¯¯|
|                                           |
|                                           |
|═══════════════════════════════════════════|