|¯¯¯¯¯┌────────────┐¯¯¯¯¯¯¯¯¯¯¯¯¯¯¯¯¯¯¯¯¯¯¯┌────────────┐¯¯¯¯¯|
|     ├─║║──────║║║┤                       ├─║║──────║║║┤     |
|     ├────────────┤          ┌─┐          ├────────────┤     |
|═════├──║║║║║║║║──┤══════════| |══════════├──║║║║║║║║──┤═════|
|     ├────────────|                       ├────────────|     |
|/¯¯\                                                         |
||¯¯|               __                              |    /¯¯¯\|
|/¯¯\              /_/                              |--┐ |¯¯¯||
||¯¯|                                               /¯¯\ |   ||
||  |                                                    └───┘|
|└──┘                             \¯\                         |
|                                  ¯¯                         |
|¯¯¯¯¯¯¯¯¯¯¯¯¯¯¯¯¯¯¯¯¯¯¯¯¯¯¯¯¯¯¯¯¯¯¯¯¯¯¯¯¯¯¯¯¯¯¯¯¯¯¯¯¯¯¯¯¯¯¯¯¯|
|                                                             |
|                                                             |
|═════════════════════════════════════════════════════════════|