|¯¯¯¯¯¯¯¯¯¯¯¯¯¯¯¯¯¯¯¯¯¯¯¯¯¯¯¯¯¯¯¯¯¯¯¯¯¯¯|
|    ┌────┐┌────┐                       |
|    ├────┤├────┤                       |
|════|.*.*||.*.*|═══════════┌────┐══════|
|+   └────┘└────┘           ├────┤      |    Almacen
|                     ┌────┐|.*.*|      |
|┌────┐               ├────┤└────┘      |
|├────┤         ┌────┐|.*.*|    ┌────┐  |
||.*.*|         ├────┤└────┘    ├────┤  |
|┌────┐    +    |.*.*|┌────┐    |.*.*|  |
|├────┤         └────┘├────┤    └────┘  |
||.*.*|               |.*.*|┌────┐      |
|└────┘               └────┘├────┤     +|
|¯¯¯¯¯¯¯¯¯¯¯¯¯¯¯¯¯¯¯¯¯¯¯¯¯¯¯¯¯¯¯¯¯¯¯¯¯¯¯|
|                                       |
|                      ┌─┐              |
|══════════════════════| |══════════════|