|¯¯¯¯¯¯¯¯¯¯¯¯¯¯¯¯¯¯¯¯¯¯¯¯¯¯¯¯¯¯¯¯¯¯¯¯¯¯¯|
|         ┌────┐                        |
|   ┌────┐├────┤                        |
|═══├────┤|.*.*|════════════┌────┐══════|
|*  |.*.*|└────┘            ├────┤      |    Almacen
|┌────┐──┘            ┌────┐|.*.*|      |
|├────┤               ├────┤└────┘┌────┐|
||.*.*|         ┌────┐|.*.*|      ├────┤|
|└────┘         ├────┤└────┘      |.*.*||
|┌────┐         |.*.*|┌────┐      └────┘|
|├────┤         └────┘├────┤   *        |
||.*.*|               |.*.*|┌────┐      |
|└────┘               └────┘├────┤      |
|¯¯¯¯¯¯¯¯¯¯¯¯¯¯¯¯¯¯¯¯¯¯¯¯¯¯¯¯¯¯¯¯¯¯¯¯¯¯¯|
|                                       |
|                      ┌─┐              |
|══════════════════════| |══════════════|