|¯¯¯¯¯¯¯¯¯¯¯¯¯¯¯¯¯¯¯¯¯¯¯¯¯¯¯¯¯¯¯¯¯¯¯¯¯¯¯|
|         ┌────┐                        |
|   ┌────┐├────┤                        |
|═══├────┤|.*.*|════════════┌────┐══════|
|+  |.*.*|└────┘            ├────┤      |    Almacen
|┌────┐──┘            ┌────┐|.*.*|      |
|├────┤               ├────┤└────┘┌────┐|
||.*.*|         ┌────┐|.*.*|      ├────┤|
|└────┘         ├────┤└────┘      |.*.*||
|┌────┐         |.*.*|┌────┐      └────┘|
|├────┤         └────┘├────┤   +        |
||.*.*|               |.*.*|┌────┐      |
|└────┘               └────┘├────┤      |
|¯¯¯¯¯¯¯¯¯¯¯¯¯¯¯¯¯¯¯¯¯¯¯¯¯¯¯¯¯¯¯¯¯¯¯¯¯¯¯|
|                    |     |            |
|                    | ┌─┐ |            |
|══════════════════════| |══════════════|